X X N X X
X X N X X
X X N X X
X X E X X
X X X X X