E E N E N N
E E E E E E
X N N N E X
X X E N X X
X X X X X X